13 13 13 13 13 13 13 13 13 13 13 13 13 13
13 19 19 19 19 19 19 19 19 19 19 19 19 13
13 19 19 19 19 19 19 19 19 19 19 19 19 13
13 19 19 19 19 19 19 19 19 19 19 19 19 13
13 19 19 19 19 19 19 19 19 19 19 19 2 13
13 19 19 19 19 19 19 19 19 19 19 13 13 13
13 19 19 19 19 19 19 19 19 19 13 13 13 13
13 13 13 13 16 16 16 13 13 13 13 13 13 13
13 13 13 13 16 16 16 13 13 13 13 13 13 13
13 16 16 16 13 16 16 16 16 16 16 16 16 13
13 16 16 16 16 16 13 16 16 16 16 16 16 13
13 16 16 5 16 16 16 16 16 16 16 16 16 13
13 16 16 16 13 16 16 16 16 16 16 16 16 13
13 16 16 16 16 16 16 16 13 16 16 16 16 13
13 16 16 16 16 16 16 16 5 16 16 16 16 13
13 16 16 16 16 16 16 16 16 16 16 16 16 13
13 16 16 16 16 16 13 16 16 16 16 16 16 13
13 16 16 16 16 16 5 16 16 16 16 16 16 13
13 16 16 13 16 16 16 16 16 16 16 16 16 13
13 16 16 5 16 16 16 16 16 16 16 16 16 13
13 13 16 16 16 16 16 16 16 16 16 16 16 13
13 16 16 16 16 16 13 13 16 16 16 16 16 13
13 16 16 13 16 16 16 16 16 16 16 16 16 13
13 16 16 16 16 16 16 16 16 13 16 16 16 13
13 16 16 16 16 16 16 16 16 16 16 16 16 13
13 16 16 16 16 16 16 16 16 16 16 16 16 13
13 13 16 16 16 16 13 13 16 16 16 13 13 13
13 16 16 16 16 16 16 16 16 16 16 16 16 13
13 16 16 16 16 16 16 16 16 16 16 16 16 13
13 16 16 16 13 13 13 13 13 13 13 13 13 13
13 16 16 16 13 16 16 16 16 16 16 16 16 13
13 13 16 16 13 16 16 16 16 16 16 16 16 13
13 16 16 16 16 16 16 16 16 16 13 16 16 13
13 16 16 16 13 16 16 16 16 16 16 16 16 13
13 13 16 13 13 16 13 16 16 16 16 16 16 13
13 16 5 16 16 16 16 16 16 16 16 13 16 13
13 16 16 16 16 16 16 16 16 16 16 16 16 13
13 16 16 16 16 16 16 16 16 16 16 16 16 13
13 16 16 16 13 13 13 16 16 13 16 16 13 13
13 16 16 16 16 16 16 16 16 16 16 16 16 13
13 16 13 16 16 16 16 16 16 16 16 16 16 13
13 16 16 16 16 16 16 16 16 16 16 16 16 13
13 16 16 16 13 13 16 13 13 16 16 16 16 13
13 16 16 16 16 16 16 16 16 16 16 13 16 13
13 16 16 16 16 16 16 16 16 16 16 16 16 13
13 16 16 16 16 16 16 16 16 16 18 16 16 13
13 13 13 13 15 15 15 13 13 13 13 13 13 13
12 12 12 12 14 14 14 12 12 12 12 12 12 12
12 12 12 12 12 4 4 12 12 12 12 12 12 12
12 4 4 4 4 4 4 4 4 4 4 4 4 12
12 4 4 4 4 4 4 4 4 4 4 4 4 12
12 4 4 12 12 12 12 12 4 4 4 4 4 12
12 4 4 4 4 4 4 4 4 4 4 4 4 12
12 4 4 4 4 4 4 4 4 4 4 4 4 12
12 4 4 4 4 4 4 4 4 4 12 12 12 12
12 4 4 4 4 4 4 4 12 4 4 4 4 12
12 4 4 4 4 4 4 4 4 4 4 4 4 12
12 4 4 4 4 4 12 4 4 4 4 4 4 12
12 4 4 4 4 4 4 4 4 4 4 4 4 12
12 4 4 4 12 4 4 4 4 4 4 4 4 12
12 12 4 4 4 5 5 5 5 5 5 5 5 12
12 4 4 4 4 4 4 4 4 4 4 4 4 12
12 4 4 4 4 4 4 4 4 4 4 4 4 12
12 12 12 12 4 4 4 4 4 4 4 4 4 12
12 4 4 4 12 4 4 4 4 4 4 4 4 12
12 4 4 4 4 5 4 12 4 4 12 4 4 12
12 4 4 4 4 4 4 4 4 4 5 4 4 12
12 4 4 4 4 4 4 4 4 4 4 4 4 12
12 4 4 4 4 4 4 4 4 4 4 4 12 12
12 4 4 4 4 4 12 4 4 12 4 4 4 12
12 4 4 4 12 4 4 4 4 4 4 4 4 12
12 12 4 4 4 4 4 4 4 4 4 4 4 12
12 4 4 4 4 4 4 4 4 4 4 4 4 12
12 4 4 12 4 4 12 4 4 4 4 5 5 12
12 4 4 4 4 4 4 4 4 4 12 12 12 12
12 4 4 4 4 4 4 4 4 4 4 4 4 12
12 5 4 4 4 12 12 12 4 4 4 4 4 12
12 12 4 4 4 4 4 4 4 4 4 4 4 12
12 4 4 4 4 4 4 4 4 4 4 4 4 12
12 12 12 12 4 4 4 4 4 4 4 4 4 12
12 4 4 4 4 4 12 4 4 4 4 4 4 12
12 4 4 4 4 4 4 4 4 4 4 4 4 12
12 4 4 4 4 4 4 4 4 4 4 4 4 12
12 12 12 12 12 12 4 4 4 12 12 12 12 12
11 4 4 4 4 4 4 4 4 4 4 4 4 10
11 4 4 4 4 4 4 4 4 4 4 4 4 10
11 4 4 4 4 4 4 4 4 4 4 17 4 10
1 1 4 4 4 3 3 3 3 3 3 3 3 1
1 0 0 0 0 1 1 1 1 1 1 1 1 1
1 0 0 0 1 1 1 1 1 1 1 1 1 1
1 0 0 0 0 0 0 0 0 0 0 0 0 1
1 1 0 0 0 0 0 0 0 0 0 0 0 1
1 0 0 0 0 0 0 0 0 0 0 0 0 1
1 1 1 1 0 0 0 0 0 0 0 0 0 1
1 0 0 0 0 0 0 0 0 0 0 0 0 1
1 0 0 0 0 1 0 0 0 0 0 0 0 1
1 0 0 0 0 0 0 0 0 0 0 0 0 1
1 0 0 0 0 0 0 0 1 0 0 0 0 1
1 0 0 0 0 0 0 0 0 0 0 0 0 1
1 0 0 0 0 0 0 0 0 0 0 0 0 1
1 0 0 0 0 0 1 0 0 0 0 0 0 1
1 0 0 0 0 0 0 0 0 0 0 0 0 1
1 0 0 0 0 0 0 0 0 0 0 0 0 1
1 0 0 0 0 0 0 0 1 0 0 0 0 1
1 0 0 0 0 0 0 0 0 0 0 0 0 1
1 0 0 0 0 0 0 0 0 0 0 0 0 1
1 0 0 0 0 0 1 0 0 0 0 0 0 1
1 0 0 0 0 0 0 0 0 0 0 0 0 1
1 0 0 0 1 0 0 0 0 0 0 0 5 1
1 5 0 0 0 0 0 0 1 1 1 1 1 1
1 1 1 1 0 0 0 0 0 0 0 0 0 1
1 0 0 5 0 0 0 0 0 0 0 0 0 1
1 0 0 1 1 1 0 0 0 0 0 0 0 1
1 0 0 0 0 0 0 0 1 1 1 0 0 1
1 0 0 0 0 5 0 0 0 0 0 0 0 1
1 0 0 0 0 1 0 0 0 0 0 0 0 1
1 0 0 0 0 0 0 1 0 0 0 0 0 1
1 0 0 0 0 0 0 0 1 0 0 6 0 1
1 0 0 0 0 0 0 0 0 0 0 1 1 1
1 0 0 0 0 0 0 0 0 0 1 0 0 1
1 0 5 0 0 0 0 0 0 0 0 0 0 1
1 1 1 1 1 1 1 1 0 0 0 0 0 1
1 1 1 1 1 1 0 0 1 0 0 0 0 1
1 0 0 7 0 0 0 0 0 0 0 0 0 1
1 0 8 0 9 0 0 0 0 0 0 1 1 1
1 0 0 0 0 0 6 6 6 0 0 0 0 1
1 1 1 1 1 1 1 1 1 1 1 1 1 1